11111
10CE1
10C01
1PC!1
11111

