1111111111
1E11100P01
111C000011
1111111111
