11111
100E1
10C011
1PC01
11111